continent_1 = {
	provinces = {
		26 27 28 29 30 31 32 33 34 35 36 37 38 39 41 42 44 45 46 47 49 50 51 52 53 54 55 56 57 58 59 60 61 62 63 64 65 66 67 68 69 70 71 72 73  75 76 77 78 79 80 81 82 83 84 85 86 87 88 89 90 91 95 96 97 98 99 100 101 102 103 104 105 106 107 108 110 111 112 114 115 116 117 118 120 121 122 123 124 125 126 127 128 129 130 131 132 133 134 135 136 137 139 142 145 149 150 151 152 153 154 155 156 157 158 159 161 162 163 166 167 168 169 170 171 172 174 175 176 177 178 179 180 182 183 184 185 186 187 188 189 190 191 192 193 194 195 196 197 198 199 201 202 203 204 205 207 208 210 211 212 213 214 215 216 217 218 219 220 221 222 223 224 226 227 228 231 232 234 235 237 238 239 240 241 242 243 245 247 248 249 250 252 255 256 257 258 259 260 261 262 263 264 265 266 267 268 269 270 271 272 273 274 275 276 277 278 279 280 281 282 283 285 287 288 289 290 291 292 293 294 295 296 297 298 299 300 301 302 303 304 305 306 307 308 309 310 311 312 314 315 317 318 319 320 323 324 325 326 327 328 330 331 332 333 334 335 336 337 338 341 342 343 345 346 347 348 349 350 351 352 353 354 355 356 357 358 359 361 362 364 365 366 367 368 369 370 371 372 373 374 375 376 377 378 379 380 381 383 384 385 386 387 388 389 390 391 392 393 394 396 398 399 400 401 402 404 405 406 407 410 411 412 413 415 416 417 418 420 421 422 423 425 426 427 428 429 430 431 432 434 435 436 437 438 439 440 441 442 443 444 445 446 447 448 449 451 452 453 455 456 458 459 460 461 463 464 465 466 467 468 469 470 472 474 475 476 477 478 479 481 482 483 484 485 486 487 488 489 490 491 492 493 494 495 496 497 498 499 501 502 504 505 507 510 511 512 514 516 517 518 520 521 522 527 529 530 531 533 536 537 538 542 546 552 554 555 556 558 559 562 563 564 568 569 571 572 574 578 584 588 589 591 592 594 596 598 602 604 608 610 611 617 618 621 623 633 634 636 640 646 647 648 649 655 657 665 666 678 683 696 697 700 712 723 727 741 751 753 755 766 768 777 778 798 802 803 809 818 829 845 852 853 870 878 879 890 892 896 905 911 916 925 926 929 941 948 964 970 983 984 996 997 1020 1023 1024 1051 1069 1080 1099 1126 1159 1170 1202 1204 1206 1207 1219 1222 1230 1269 
	}
}

continent_2 = {
	provinces = {
		503 508 509 515 519 526 528 534 535 543 544 545 547 549 550 551 557 561 565 566 576 577 579 580 582 583 585 586 590 593 595 599 600 601 603 605 606 607 609 612 613 614 615 619 620 624 625 627 628 629 630 631 632 635 637 638 639 641 642 644 645 651 652 653 654 656 658 659 660 661 662 664 667 669 670 672 673 674 675 676 677 679 681 682 685 686 687 688 689 691 692 693 694 695 698 699 702 703 704 705 706 707 708 711  714 715 716 717 718 719 720 721 722 726 729 730 731 732 733 734 735 736 737 738 739 740 742 743 744 745 746 747 749 750 752 757 758 759 760 761 762 763 764 765 769 770 771 772 773 774 775 776 779 780 781 782 783 784 785 786 787 788 789 790 791 792 793 795 796 800 801 804 805 806 807 808 810 811 812 813 814 815 816 817 819 820 821 822 823 824 825 826 828 831 833 834 835 836 838 839 840 841 842 843 844 847 848 849 851 855 856 857 860 861 862 863 864 865 866 867 868 869 871 872 873 874 875 876 877 881 882 883 884 885 886 887 888 889 891 894 895 897 899 900 901 902 903 906 907 908 909 910 912 913 914 915 917 918 919 920 921 922 923 924 927 928 930 931 932 933 934 935 937 938 939 942 943 944 946 947 949 950 951 952 953 954 956 957 958 959 960 961 962 963 965 967 968 969 971 972 976 977 979 980 981 982 985 986 988 989 990 992 994 995 998 999 1000 1002 1003 1004 1005 1006 1007 1008 1010 1011 1012 1013 1014 1015 1016 1017 1019 1022 1025 1026 1027 1029 1030 1031 1032 1033 1037 1038 1039 1040 1041 1042 1044 1046 1047 1048 1049 1050 1053 1054 1055 1057 1058 1059 1060 1061 1062 1063 1064 1065 1067 1071 1075 1076 1077 1081 1082 1085 1088 1089 1090 1091 1095 1096 1097 1098 1101 1104 1105 1106 1109 1110 1112 1113 1115 1118 1119 1120 1127 1130 1133 1135 1136 1140 1142 1143 1154 1157 1160 1161 1162 1164 1174 1178 1182 1185 1186 1187 1190 1193 1196 1200 1209 1211 1214 1215 1224 1225 1229 1231 1257 1264 1266 1273 1274 1279 1287 1295 1303 1314 1316 1323 1326 1338 1343 1344 1349 1382 1384 1390  837
	}
}

continent_4 = {
	provinces = {
		936 955 973 975 993 1043 1052 1068 1072 1084 1086 1092 1107 1111 1114 1117 1122 1123 1128 1131 1137 1139 1145 1149 1150 1151 1156 1163 1166 1167 1175 1176 1177 1179 1180 1184 1189 1198 1199 1201 1203 1205 1216 1217 1220 1221 1223 1226 1228 1233 1234 1237 1238 1239 1240 1241 1244 1246 1248 1250 1252 1253 1254 1259 1260 1261 1262 1263 1265 1268 1270 1271 1277 1278 1281 1282 1283 1284 1285 1286 1289 1290 1291 1292 1293 1294 1296 1298 1299 1300 1301 1306 1307 1309 1310 1313 1317 1318 1320 1321 1322 1327 1328 1329 1331 1332 1333 1335 1339 1341 1342 1346 1347 1351 1352 1353 1355 1356 1358 1360 1365 1366 1368 1371 1373 1379 1380 1381 1383 1385 1387 1389 1391 1392 1396 1397 1399 1400 1401 1403 1404 1405 1406 1407 1408 1410 1411 1412 1413 1415 1418 1420 1423 1426 1427 1428 1429 1431 1432 1435 1437 1438 1440 1442 1443 1444 1445 1446 1451 1452 1453 1454 1456 1457 1460 1461 1464 1465 1466 1468 1469 1470 1473 1475 1476 1477 1478 1480 1481 1483 1484 1485 1487 1492 1493 1495 1496 1499 1500 1501 1504 1505 1506 1508 1509 1510 1511 1512 1513 1514 1515 1516 1518 1519 1520 1521 1522 1524 1525 1529 1530 1531 1532 1533 1535 1536 1538 1539 1542 1544 1546 1547 1548 1549 1551 1552 1553 1554 1558 1559 1560 1562 1563 1565 1566 1567 1570 1573 1575 1576 1577 1578 1582 1585 1587 1589 1590 1592 1593 1594 1596 1597 1598 1599 1602 1603 1604 1605 1606 1608 1609 1610 1612 1613 1615 1616 1620 1621 1624 1625 1626 1627 1629 1634 1636 1643 1645 1646 1647 1649 1650 1651 1658 1659 1660 1661 1663 1664 1666 1667 1669 1673 1675 1676 1680 1682 1683 1685 1686 1691 1693 1694 1695 1700 1701 1703 1704 1705 1709 1712 1713 1714 1716 1717 1718 1720 1721 1723 1724 1726 1728 1729 1730 1732 1734 1735 1739 1743 1744 1745 1746 1749 1752 1753 1755 1764 1768 1770 1775 1778 1779 1787 1789 1793 1799 1801 1807 1812 1815 1817 1823 1829 1833 1838 1841 1853 1862 1864 1870 1872 1882 1892 1894 1896 1903 1904 1908 1909 1917 1927 1933 1940 1951 1952 1955 1958 1964 1981 1982 1984 1998 2000 2005 2017 2020 2037 2041 2042 2049 2068 2088 1074 1235
	}
}

continent_7 = {
	provinces = {
		1345 1357 1386 1414 1417 1439 1448 1449 1471 1482 1486 1503 1517 1528 1540 1541 1543 1545 1557 1561 1568 1580 1581 1584 1591 1600 1601 1618 1622 1623 1630 1632 1637 1638 1639 1642 1648 1652 1654 1656 1662 1674 1677 1684 1692 1696 1697 1699 1702 1708 1711 1719 1722 1733 1736 1737 1738 1741 1742 1750 1756 1760 1761 1767 1769 1771 1772 1773 1774 1776 1777 1780 1781 1783 1785 1786 1790 1794 1795 1796 1797 1800 1802 1803 1804 1805 1806 1808 1809 1810 1813 1816 1818 1819 1820 1821 1822 1824 1826 1827 1828 1831 1832 1835 1836 1837 1839 1840 1842 1845 1848 1849 1850 1851 1852 1854 1855 1857 1859 1860 1861 1865 1866 1867 1869 1871 1873 1874 1876 1877 1878 1879 1881 1883 1884 1885 1886 1887 1888 1891 1893 1895 1897 1899 1900 1906 1907 1910 1911 1912 1913 1914 1915 1916 1919 1920 1921 1922 1923 1924 1925 1928 1929 1930 1931 1932 1934 1935 1936 1937 1938 1939 1941 1944 1946 1947 1948 1949 1950 1953 1956 1957 1960 1961 1962 1967 1968 1970 1972 1974 1975 1976 1977 1978 1979 1980 1983 1987 1988 1989 1990 1992 1993 1994 1995 1996 1997 2001 2002 2004 2007 2009 2010 2011 2012 2013 2014 2015 2016 2018 2021 2023 2024 2025 2027 2028 2029 2030 2031 2033 2034 2035 2036 2039 2040 2043 2044 2045 2046 2047 2050  2052 2053 2054 2055 2056 2057 2058 2059 2060 2062 2063 2064 2065 2067 2069 2070 2071 2072 2073 2075 2076 2077 2078 2079 2080 2081 2082 2083 2084 2085 2086 2087 2089 2090 2091 2092 2093 2094 2096 2098 2099 2100 2101 2102 2103 2104 2105 2106 2107 2108 2109 2110 2111 2112 2113 2114 2115 2116 2118 2119 2120 2121 2122 2124 2125 2126 2127 2128 2129 2130 2131 2132 2133 2134 2137 2138 2139 2140 2141 2142 2143 2144 2145 2146 2147 2148 2149 2150 2152 2153 2154 2155 2156 2157 2158 2159 2161 2162 2163 2164 2165 2166 2167 2168 2169 2170 2171 2172 2173 2174 2175 2176 2177 2178 2179 2181 2183 2184 2187 2188 2190 2191 2192 2194 2195 2196 2197 2199 2203 2204 2206 2208 2209 2210 2211 2212 2213 2214 2216 2220 2221 2222 2223 2224 2225 2227 2228 2229 2231 2232 2234 2235 2237 2238 2240 2241 2242 2243 2244 2245 2246 2247 2248 2249 2250 2251 2253 2254 2255 2256 2257 2258 2259 2260 2262 2263 2264 2265 2266 2267 2268 2269 2270 2271 2272 2273 2276 2277 2278 2279 2281 2282 2284 2285 2287 2288 2289 2290 2291 2292 2293 2294 2295 2296 2298 2299 2300 2301 2303 2304 2305 2306 2307 2308 2309 2311 2312 2313 2314 2316 2318 2320 2321 2323 2324 2325 2327 2328 2329 2330 2332 2333 2334 2335 2336 2337 2338 2339 2340 2341 2342 2344 2346 2348 2349 2350 2351 2353 2354 2355 2356 2358 2360 2363 2364 2367 2368 2372 2373 2374 2375 
	}
}

continent_8 = {
	provinces = {
		1362 1364 1377 1394 1395 1409 1419 1422 1430 1434 1436 1447 1455 1459 1462 1463 1467 1490 1497 1498 1507 1523 1526 1527 1534 1555 1556 1564 1569 1574 1586 1607 1614 1617 1631 1635 1641 1644 1671 1678 1679 1687 1688 1710 1715 1727 1731 713 2051 74 200
	}
}

europe = { 
	provinces = { 

	} 
	#assimilation_rate = -0.25
} 
 
asia = { 
	provinces = { 

	} 
	#assimilation_rate = -0.25
 
} 
 
africa = { 
	provinces = { 

	} 
	#assimilation_rate = -0.25
 
} 
 
north_america = { 
	provinces = { 














	} 
	assimilation_rate = 0.5
	farm_rgo_size = 10
	mine_rgo_size = 10
} 
 
south_america = { 
	provinces = { 










	} 
	assimilation_rate = 0.5
	farm_rgo_size = 10.0
	mine_rgo_size = 10.0
 
} 
 
oceania = { 
	provinces = { 





	} 
	assimilation_rate = 0.5
	farm_rgo_size = 10.0
	mine_rgo_size = 10.0
} 

